[
  [1, 1, 1, 1, 1, 1, 1, 1, 1, 1, 1, 1],
  [1, 1, 1, 1, 1, 1, 1, 1, 1, 1, "y", 1],
  [1, 0, 0, 0, 1, 0, 0, 0, 0, 0, 0, 1],
  [1, 0, 1, 0, 1, 0, 1, 1, 1, 1, 1, 1],
  [1, 0, 1, 0, 0, 0, 0, 0, 0, 1, 1, 1],
  [1, 2, 1, 1, 1, 1, 0, 1, 0, 0, 0, 1],
  [1, 0, 1, 1, 1, 1, 0, 1, 1, 1, "y", 1],
  [1, 0, 1, "y", 0, 0, 0, 0, "s", 1, 0, 1],
  [1, 0, 1, 1, 1, 1, 1, 1, 1, "y", 1, 1],
  [1, 0, 0, 0, 1, 1, 1, 1, 1, 0, 1, 1],
  [1, 1, 1, 0, 0, 0, 0, 0, 0, 0, 1, 1],
  [1, 1, 1, 1, 1, 1, 1, 1, 1, 1, 1, 1]
]