[
  [1, 1, 1, 1, 1, 1, 1, 1],
  [1, "y", 1, 0, 0, 0, 1, 1],
  [1, 0, 1, 0, 1, 0, 0, 1],
  [1, 0, 1, 0, 0, 1, 0, 1],
  [1, "s", 0, 0, 0, 1, 0, 1],
  [1, 1, 1, 1, 1, 1, 0, 1],
  [1, 2, 0, 0, 0, 0, 0, 1],
  [1, 1, 1, 1, 1, 1, 1, 1]
]